1111111111
1000000001
10000000011
1000000001
1111111111