1111111111
1P000000C1
100C000001
10000C1111
10C00010E1
1111111111