1111111111
1P000000C1
100C000001
10000C001
10C00000E1
1111111111