1111111111
1P000S00C1
100C000001
10S00C0001
10C0S000E1
1111111111