1111111111
1P000000C1
100C000E01
10000C0001
10C00000E1
1111111111