1111111111
1P000000C1
100C000001
10000C0001
10C0000001
1111111111